################################################################################
#..#...........................................................................#
#..|................................................................#.#.#.#.#..#
####.................###................................###........###########.#
#....................###................................###.........#.#.#.#.#..#
#....................###................................###....................#
#...................................................................#.#.#.#.#..#
#..................................................................###########.#
#...................................................................#.#.#.#.#..#
#......................................M.......................................#
#...................................................................#.#.#.#.#..#
#..................................................................###########.#
#...................................................................#.#.#.#.#..#
#..............................................................................#
#....................###................................###....................#
#....................###................................###....................#
#....................###................................###....................#
#..............................................................................#
#..............................................................................#
################################################################################
