################################################################################
#@.#...........................................................................#
#..|................................................................#.#.#.#.#..#
####.................###................................###........###########.#
#....................###................................###.........#.#.#%#.#..#
#....................###................................###....................#
#...................................................................#.#.#.#~#..#
#..................................................................###########.#
#...................................................................#.#.#.#.#..#
$..................................*...M.......................................#
$...................................................................#.#.#.#.#..#
#..................................................................###########.#
#...................................................................#.#^#.#.#..#
#..............................................................................#
#....................###................................###....................#
#....................###................................###....................#
#....................###................................###....................#
#........................................................./....................#
#..............................................................................#
################################################################################
